 # # # # # # # # # # # # # # # # # # # #
 # . . . # . . . . . . # . . . . # . . #
 . . # . # . # # # # . # . # # # . # . #
 # # # . # . . . . # . # . # . . . # . #
 # . . . . # # # . # . # . # . # # # . #
 # # # # . # F # . # . # . . . # . . . #
 # . . # . # . # . # . # # # . # . # # #
 # # . # . # . # . # . # . . . # . # . #
 # . . . . . . . . # . # . # # # . # . #
 # # # # # # . # # # . # . # . . . . . #
 # . . . . . . # . . . # . # # . # # # #
 # . # # # # # # . # # # . . # . # . . #
 # . # . . . . # . . . . # . # . # . # #
 # . # . # # . # . # # . . . # . . . . #
 # . # . # . . . . # . . # # # # # # . #
 # . # . # . # # . # . # . . . . . . . #
 # . # # # . . . # . . # . # . # . # # #
 # . . . # # # # # . # # . # . # . # . #
 # . # . . . # . . . . . . # . # . . . #
 # . # # # . # . # # # # # # # # # . # #
 # . # . # . # # . . . # . . . . # # # #
 # . . . # . . . . # . # . # . # . . . #
 # . # . # . # # # # . # . # . # . # . #
 # # # . # . . . . # . # . # . . . # . #
 # . . . . # # # . # . # . # . # # # . #
 # # # # . # . # . # . # . . . # . . . #
 # . . # . # . # . # . # # # . # . # # #
 # # . # . # . # . # . # . . . # . # . #
 # . . . . . . # . # . # . # # # . # . #
 # # # # # # . # # # . # . # . . . . . #
 # . . . . . . # . . . # . # # . # # # #
 # . # # # # # # . # # # . . # . # . . #
 # . # . . . . # . . . . # . # . # . # #
 # . # . # # . # . # # . . . # . . . . #
 # . # . # . . . . # . . # # # # # # . #
 # . # . # . # # . # . # . . . . . . . #
 # . # # # . . . # . . # . # . # . # # #
 # . . . # # # # # . # # . # . # . # . #
 # . # . . . # . . . . . . # . # . . . #
 # # # # # # # # # # # # # # # # # # # #
